***************************
*+H+++++++++++++++++++++++*
*+*+*******************T*+*
*+*+ +++++++++++++++++++*+*
*+*+*+*+***************+*+*
*+*+*+*+++++++++++++++ +*+*
*+*+*+*+***********T*+*+*+*
*+*+*+*+ +++++++++++*+*+*+*
*+*+*+*+*+*T*******+*+*+*+*
*+*+*+*+*+*+++++++ +*+*+*+*
*+*+*+*+*+*+*** *+*+*+*+*+*
*+*+*+*+*+*+*+++*+*+*+*+*+*
*+*+*+*+*+*+*+*+*+*+*+*+*+*
*+*+*+*+*+*+*|*+*+*+*+*+*+*
*+*+*+*+*+*+*T*+*+*+*+*+*+*
*+*+*+*+*+*+++++*+*+*+*+*+*
*+*+*+*+*+* *****+*+*+*+*+*
*+*+*+*+|+++++++++*+*+*+*+*
*+*+*+*+********* *+*+*+*+*
*+*+*+*+++++++++++++ +*+*+*
*+*+*+* *************+*+*+*
*+*+ +++++++++++++++++*+*+*
*+*+*****************T*+*+*
*+*+++++++++++++++++++++|+*
*+* *********************+*
*+++++++++++++++++++++++++*
************XXX************
