***************************
*   *        *        *   *
* * * ****** * ****** * * *
* * * *      *      * * * *
* * * * *********** * * * *
* * * *             * * * *
* * * *************** * * *
* * * *             * * * *
* * * * *********** * * * *
* * * * *   *   *D* * * * *
* * * * * * +H* *x* * * * *
* * * * * ***** * * * * * *
* *   * *     *   * *   * *
* ***** ***** ***** ***** *
* *   * *   * *   * *   * *
* * * * * * * * * * * * * *
* * * * * * * * * * * * * *
* * * * * * * * * * * * * *
* * * * * * * * * * * * * *
* * * *   * *   *   * * * *
* * * ***** ********* * * *
* * *       *         * * *
* * ********* ********* * *
* *         * *         * *
* ********* * * ********* *
*           * *           *
*************X*************