***************************
*              M  *+++++++*
* * *** *********** * * * *
* * * * *           * * * *
* * * * * ***** * * * * * *
* * * *       * * * * *+* *
* * * ******* * * * * *+* *
*   +++++++ * *  ** * *+* *
* * *****   *  *  * * *+* *
* * *+* * *++*  * * * *+* *
* * *+* *M**++*  ** *+*+* *
* * *+* * * *++*  * *+*+* *
* * *+* * * **++* * *+*+* *
* * *+* * *   *+* * *+*+* *
* * *+* * * * *+* * *+* * *
* * *+* * * * *+* * *+* * *
* * *+* * * * *+* * *+* * *
* *         *  +* * *+*M* *
* * ****** ****** * *+* * *
* *        ****** * *+* * *
****** ********** * *+* * *
*+++++++++++++++* * * * * *
* *************** * * * * *
* *++++++++++++ * *     * *
* ************* * ******* *
*            M            *
***************************