***************************
*                 *+++++++*
* * *** *********** * * * *
* * * * *           * * * *
* * * * * ***** * * * * * *
* * * *       * * * * *+* *
* * * ******* * * * * *+* *
*   +++++++ * *  ** * *+* *
* * *****   *  *  * * *+* *
* * *+* * *++*  * * * *+* *
* * *+* * **++*  ** *+*+* *
* * *+* * * *++*  * *+*+* *
* * *+* * * **++* * *+*+* *
* * *+* * *   *+* * *+*+* *
* * *+* * * * *+* * *+* * *
* * *+* * * * *+* * *+* * *
* * *+* * * * *+* * *+* * *
* *         *  +* * *+* * *
* * ****** ****** * *+* * *
* *        ****** * *+* * *
****** ********** * *+* * *
*+++++++++++++++* * * * * *
* *************** * * * * *
* *++++++++++++ * *     * *
* ************* * ******* *
*                         *
***************************

