***************************
*                         *
* *********************** *
* *********************** *
* *********************** *
* *********************** *
* *********************** *
* *********************** *
* *********************** *
* *********************** *
* *********************** *
* *********************** *
* *********************** *
* *********************** *
* *********************** *
* *********************** *
* *********************** *
* *********************** *
* *********************** *
* *********************** *
* *********************** *
* *********************** *
* *********************** *
* *********************** *
* *********************** *
*                         *
************XXX************