***************************
* ++++++++++++H           *
* ************ ****** *+* *
* *          *   ++++ *+* *
* * * **** * * * **** *+* *
X * *  D   * * * ++++ *+* *
X * * **** * * * **** *+* *
X *          * * ++++ *+* *
* * ******** * * **** *+* *
* *          * *   M  *+* *
* *xxxxxxxxxx* * *  *   * *
*            *   *  ***** *
* ********** * + + + + +  *
*            * ************
* ************            *
*    M + + + + ********** *
*+********* * *+++++++++++*
*+* +++++++ * * * ******* *
*+* ********* *+* *+++++* *
*+*         * *+* * * * * *
*   *******   *+* * * * * *
*+* +++++++ * *+* *+++* * *
*+********* * *+* ***** * *
*+*         * * *+++++++* *
*+* ********* * ********* *
*     M +++++ *      M    *
***************************